0WWWWWWWWWWWWWW
0W0W0W0W00W0W0W
0W000B0WD0W000W
0WWW0W0^0BWW0^W
WW0W0B00^0W000W
WP0W0W0^00W0^0W
WW0W0W0^^0W0^0WWW
0W0W0^0000W0W00NW
0W000^0^^000W0WWW
0WWWWWWWWWWWWWW