0000N
0WWW0WWWWWWWWWWW
0W0^00W000W00W0W
0W0WW0W0W0WW0W0W
0W000000W00W0W0W
0WW0W0W0W00W0W0W
0W00WWWWWW00000W
0W000WPW0WWWW^0W
0W0W0D0D0000000W
0WWWWWWWWWWWWWWW